"####################",
"#                 F#",
"#   #####  #####   #",
"#       #  #       #",
"#   #####  #####   #",
"                    ",
"#   #####  #####   #",
"#       #  #       #",
"#...#####  #####   #",
"#G..P             F#",
"####################",