              #######              
          ###############          
      #######################      
    ###########################    
   ####..........P..........####   
  ###...........###...........###  
 ###....F....#########.........### 
####........###########........####
####.......#############.......####
####........###########........####
 ###....G....#########....F....### 
  ###...........###...........###  
   ####.....................####   
    ###########################    
      #######################      
          ###############          
              #######              

