#######################################
# P                                 F #
#                                     #
#                 .                   #
#                                     #
#                                     #
# G                                   #
#######################################
