#######################################
#                                   F #
#                                     #
#                                     #
#                                     #
#                                     #
# G                                   #
#######################################
